 #####   #### 
 #   #####  ##
 #     @     #
 ##o#######  #
  #o#  A  # ##
###o#    @#  #
#   ## # @   #
##  #   ######
 ########     