#######        
#A    #        
# @ @ # #      
#   @ # #  ##  
# @@@@###   #  
#   @ooooo  #  
#####o###o###  
    #o# #o#    
    #o###o#####
    #ooooo@   #
    #####@@@@ #
        # @   #
        # @ @ #
        #     #
        #######