     #########     
   ###   A   ###   
#### @@@@#@@@@ ####
#   ooooooooooo   #
#  @o@@@@#@@@@o@  #
###@o@ooooooo@o@###
  # o@o@@#@@o@o #  
 ##@o@ooo@ooo@o@## 
 # @o@@@o#o@@@o@ # 
 #  ooooo@ooooo  # 
 ## @ @@ # @@ @ ## 
  #####     #####  
      #######      